
NO ./src/parsing/forbiden_fonction.txt
SO ./src/parsing/forbiden_fonction.txt
WE ./src/parsing/forbiden_fonction.txt
EA ./src/parsing/forbiden_fonction.txt
F 220,100,0
C 225,30,0

11111111111111111111111111111111
100000000011000000000000001
1011000001110000000000001111111111
1001000000000000000E00001
1111111110110000011100111111111
11111000000110000011101111
111111111111111111111111



