
NO ./src/parsing/forbiden_fonction.txt
SO ./src/parsing/forbiden_fonction.txt
WE ./src/parsing/forbiden_fonction.txt
EA ./src/parsing/forbiden_fonction.txt
F 220,100,0
C 225,30,0

1111111111111111111111111
1000000000110000000000001
1011000001110000000000001
1001000000000000000N00001
1111111110110000011100001
1000000000110000011101111
1111111111111111111111111
