
NO ./assests/textures/wall_1.xpm
SO ./assests/textures/wall_2.xpm
WE ./assests/textures/wall_3.xpm
EA ./assests/textures/wall_4.xpm
F 220,100,0
C 225,30,0

    1111111111111111111111111
    1000000000110000000000001
    1011000001110000000000001     
    100100000000000000000S001          
    1111111110110000011100111
11111000000110000011101111
1111111111111111111111111
